2 2 2 2 2 2 2 2 2 2 5 5 5 5 2 
30 1 3 1 3 1 2 2 3 1 3 1 3 1 2
31 3 1 3 1 3 1 2 1 3 1 3 1 3 2
32 1 3 1 3 1 3 1 3 1 3 1 3 1 7
33 3 1 3 1 3 1 3 1 3 1 3 1 3 7
2 1 3 1 3 1 2 8 3 1 3 1 3 1 10
6 3 1 3 1 3 2 2 1 3 1 3 1 3 2
2 2 2 9 2 9 2 2 2 2 2 2 2 2 2 