2 2 2 7 2 2 2 2 2 2 2 7 2 2 2
2 1 3 1 3 1 3 2 3 1 3 1 3 1 2
2 3 1 3 6 3 1 2 1 3 6 3 1 3 2
8 1 3 1 3 1 3 2 3 1 3 1 3 1 33
30 3 1 3 1 3 1 2 1 3 1 3 1 3 32
10 1 3 1 3 1 3 2 3 1 3 1 3 1 31
2 3 1 3 1 3 1 2 1 3 1 3 1 3 2
2 2 2 9 9 2 2 2 2 2 5 5 2 2 2
200 150