2 33 2 7 7 2 2 2 2 2 9 5 2 2 2
2 1 3 1 3 1 3 6 3 1 3 1 3 1 8
31 3 1 3 1 3 2 2 1 3 1 3 1 3 2
2 1 3 1 3 1 3 2 2 1 3 1 3 1 9
30 3 1 3 1 3 1 2 1 3 1 3 1 3 5
2 1 3 1 3 1 2 2 3 1 3 1 3 1 2
2 3 1 3 1 3 1 2 1 3 1 3 1 3 8
2 2 32 10 10 2 2 2 2 2 5 9 2 2 2
200 150